############
#     @    #
#   ########
#          #
#   &      #
#   ###### #
#          #
###    #####
#          #
#   %      #
############