############
#     @    #
########   #
#          #
#   &      #
#     ##  ##
#          #
########   #
#          #
#   %      #
############